PGPPGOGPPPPOPGGOG
GPPPPPPPPGOPPPGPP
PPPOPPPPGPPOOPPPP
PPPOPOPGPOPGPPOPG
POOPOOPOPPPGPPPPP
PPPPOOOGPPGGOPGPP
PPOPPOPPPPPPPPOPP
PPOPGPPGOPPPPOOPP
PPPOOPPPPOGPPPPPO
PGPPGPGOPPOPPPPGG
PPPPPPPPPPPPOOGOO
GPGOPOPGOOPPPPGPO
PPPOOOPGPPGPPPGGP
OPPOPPPGPOOPPGPPP
PGPOPGPPPGPGPOOGO
GPPPPPPGPPPGPPGPP
GPPPPPGPPPPPPGPPG
