PGOGGOOGPP
PGPOGPPPOP
GGOPGPPGOG
GPOPPGGOGO
GPPPPPGGGP
GOOGOPPPPG
PGPGOGOPGG
OGPPPPPPPG
GOPPGPPGPP
PPPOOOPPPG
