PPPOGPGPPOGOPOPPP
PPPGPPOGPPGPPPPPP
PPPPPOOOOPPGPOOPO
PGPOPPGPGPOPPPGPP
GPPOPPPGPPOPPGPPP
PPPPPGOPPGPGGPGPP
POPPOPPPOPPPOPPGP
PPGPPOGGPOGGGOPOO
POPPPPPGOGGPOGPPP
PGPOOPPOGGPGGOPPP
OPPPPOOPGOPPPPPPP
OGPOPPOGGOPPPPPOP
OGGPPPPGPOPGGGPPP
OGPPGOPGPPPPPGPGP
PPOPGOOGOGPPOGOOP
POGGGPPPPGPPOPPPP
GOGOPGOPOPGPPOPPP
