OGGGGGGG
POOOGOGP
PGOPOGPO
GGPOGGOP
OGGPGGGO
PPGOOGGO
PPPGOGGG
GGGPPPPO
