0 138 81 48 0 
P P P P P P P P P P F P P F P P P P F F P P P P F P M P P P F P P P P P P P P
P P F P P P F P P P P P P P P P P P P P P P P P P P P P P F F P P P P P P P P
F P F M P P P P P P P P F P P P P P P P P P P P P P P F F P P P F P P P F P F
P P P P P O P P P P P P P F P P P P P P P P P P P P P F F P P P P P P F F P M
P P P P O O O F P P P P P F F F F F F F F F P P P P F F P P P P P P P F P P M
P P P P P O P F F P P P F F F P F P P F P P P P P F P P P P P P P P P P P F P
P F F P P P F F P P P P P P P P P P M M M M F P P P P P P P P P P F F P P P P
F F P P P P F F P P M P P P P P P P M M P P F F P P P P F F F F F F F F P P P
P F P P P F P P P P M F P P P P P P P P P P F F P P P P F F F F P P F F F P P
P F F P F F P P P M M P P P P P P P P F P P P P P P P P P P O O O O O O O O O
P P P F F P P F F F P P P P F F F F F F F P P P P F F F P O O O O O O O O O O
P P P P P P P F F P F P P P P P F O O F P P P P P P F F F O O O O O O P F P P
P P P P P P P P P P F F P P P P O O O P P P P F P P P P P O O O O P P F P P P
P P F F P P P P P P F F F F F P O O O P P P F F F F P P P P P F F F F P P P P
P P F P P P P P P P F P P F F O O O F P P P P M M M M M M F F P P F P M M M P
F F P O P P P P P F P P P P P O O O F F F P P M P P P M P P P P P P P P P F M
F O O O P P P P F F P P P P P O O P P F F P P P P P P F P P P P P P P P P F P
P F O P P P P F F P P P P P P P P P F F P P P P P P P F F P P P P P P P F P P
P F F P P F F F P P P P F P P P P P F M P P F P P P P F P P P P M M F F F P P
P P P P P F F F P P P F P P P P P P M M F P P P F F P P P P P P P P M F F F P
P F P P P P P F P P F P P P P P P P P F P P P P F F P P P P P P P P P F F P P
P F F F P P P P F F F P P P F F F P F P P P P F F P P P P P P P P P P P P P P
M M P P F P P P F O O P P P F F P P P P P P F F F P P P P P P P P P P P P O O
P M M P F F P P O O P P P P P P P P F P PH F P P F F MM P P F F P P P P P P O O
P P M P F F F P P P P F F P P P F O O O P PF PF P P F MM P P F F P P P P P P O O
P P M P P F F F F P P F F F P F F O P P P P P F P MM MM P P P P P P P P P P P O
P P P P P P P P M M P P P P P P F P P P P P P P P P M M P F F P P F F P P P P
F P F F F P P P P M P P P P P P P P P F F F P P P P P M F F F P P F M F F F F
F P P F F F P P P F F F P P P F P P P P F F P F P P P F F P P P P P M P P P F
P P P P P P P P P P F P P P P P P P P P P P P P P P F F P P P P P M M P P P F
P M P P F F P P P P P M M M P P P P P P M M P P O O F F P P O O O M P P P P P
P P P P F O P P F P P P F P P F P P P P P P P P O O P P P O O O O F P P P P F
P P P P O O M P P P P P P P P P F P P P P P P F F F P P P O O O O F F P P P F
P P P P P F M M P P P P P P P P P P P P P P P F F F P P P P P P P F F F P P P
P P F P P F P M M P P F P P F M M M P P P F P P F P P P P F F P P P P P P P P
F O O P P P P P F P M P P P P P P F P P P P P P P P P P P P P P P P P P P P F
O O O O P P P P P P P P P P P P P F F P P F P P P P P P P F F P P P P P P P P
O O O O P P P P P P F P P P P P P P F P P F P P P P P P P F F P P P P P P P P
O O O O M M F P P F F F P P F F P P O O P P P P P P P P M M F P P P F P P P M
